{{// 设置
uid: 12
启用: true
类型: 蓝灯
位置: D系统
深度: 4
顺序: 310
概率: 100
主要关键字:
  - 新京都市
逻辑: 与任意
可选过滤器: []
扫描深度: 使用全局
不可递归: true
防止进一步递归: true
延迟到递归: false
粘性: null
冷却: null
延迟: null
}}
  name: 新京都市
  aliases: 东方明珠
  location: 东方大陆沿海平原
  description: 一座融合了传统魅力与未来科技的巨型国际都市。高耸入云的摩天楼与古老的神社寺庙并存，磁悬浮列车穿梭于繁忙的街道上空。作为经济与文化中心，城市由强大的女性精英统治，展现出秩序井然、充满活力的表象。然而，在霓虹灯无法照亮的阴影中，极乐公司正不断扩张其影响力，使得这座城市成为魔法少女与堕落势力交锋的最前线。
  atmosphere: 繁华, 秩序, 科技感, 母权社会特征显著, 暗流涌动, 欲望与纯洁的交锋之地。
  key_districts:
    - 中央行政区: 政府与各大企业总部所在地，权力核心，由扶她精英牢牢掌控。
    - 港湾未来区: 金融中心与高端商业区，充满了奢华的购物中心与顶级餐厅，是女性展示其社会地位与财富的舞台。
    - 洲原川娱乐区: 从歌舞伎町到地下俱乐部，这里是城市欲望的集散地，也是极乐公司主要的活动范围。
    - 霞见原魔导科技区: 魔法和平理事会下属的魔导科技研究机构所在地，守护支部也隐匿在这里的一座商业楼中，同时也是面向魔法少女粉丝的周边商品贩卖圣地。
    - 花丘新区: 精心规划的中产阶级住宅区，以其优良的社区环境和顶尖的公立教育资源而闻名，是无数家庭奋斗的目标。