{{// 设置
uid: 61
启用: true
类型: 绿灯
位置: D系统
深度: 4
顺序: 100
概率: 100
主要关键字:
  - 花丘高中
  - 学校
逻辑: 与任意
可选过滤器: []
扫描深度: 使用全局
不可递归: true
防止进一步递归: true
延迟到递归: false
粘性: null
冷却: null
延迟: null
}}
 name: 私立花丘高等中学
  aliases: 花丘高中, 
  location: 新京都市花丘新区中心地带
  description: |
    作为新京都市内享有盛誉的公立学校，花丘高中以其现代化的设施、优美的校园环境和相对自由的校风而闻名。学校建筑以米白色和浅灰色为主色调，线条简洁流畅。主教学楼前是开阔的中央庭院，种满了四季常青的植物和随季节更替的花卉，是学生们课间休憩和交谈的热门场所。花丘高中不仅注重学术成绩，更鼓励学生通过丰富的社团活动和校园文化节来发展个性和社交能力，营造出一种充满活力与青春气息的氛围。
  atmosphere: 充满活力的青春校园，洋溢着恋爱、友情与梦想的气息。
  key_features:
    - 教学楼: 分为三个年级，每个年级一栋。配备了先进的多媒体教学设备。
    - 体育馆与运动场: 拥有室内体育馆、标准游泳池和广阔的室外运动场。是学校运动系社团（基本由女性成员组成）挥洒汗水的舞台。
    - 图书馆: 藏书丰富，氛围安静。高层设有私密的学习隔间，是学霸们的主要活动区域。
    - 社团活动楼: 一栋独立的四层建筑，几乎所有文化类社团的活动室都设立于此。