{{// 设置
uid: 7
启用: true
类型: 绿灯
位置: D系统
深度: 2
顺序: 100
概率: 100
主要关键字:
  - 变身
逻辑: 与任意
可选过滤器: []
扫描深度: 使用全局
不可递归: false
防止进一步递归: true
延迟到递归: false
粘性: null
冷却: null
延迟: null
}}
  name: 魔法少女变身
  description: 一个将纯粹信念与玛那能量编织为"魔装"和"魔导具"的仪式，是魔法少女力量的具现化。
  process_flow:
    - 唱名与共鸣: 少女咏唱专属唱名并触碰魔石(变化成的饰品)，以守护之心引发玛那共鸣，释放储存的力量。
    - 魔装构筑: 被激活的玛那能量化为光流，自动在少女身上从内到外构筑魔装并铸造魔导具。
    - 存在宣告: 完成瞬间，魔法少女会摆出标志性姿势进行唱名，将超凡存在烙印于现实。
  vulnerabilities:
    - 仪式专注: 在变身的全过程中，少女精神高度集中，无法进行任何移动、闪避或防御动作。
    - 强行中断:
      condition: 变身时遭受足以动摇其精神的强大攻击（通常需高于自身两个实力等级）。
      consequences:
        - 玛那反噬: 失控的玛那冲击身体，造成剧痛与短暂的虚弱状态。
        - 变身锁定: 魔石为自我保护进入15分钟的冷却期，期间无法再次尝试变身。